2 13 29
#############################
#p * *2       *  ** * *    ##
# # # # #*# # #*# # # # #  ##
#    * * *** **      *    *##
# #*# # # # #1# #b#1# # #  ##
#          *     **      * ##
# # #*# # # # # #*#*#*#*#  ##
#   *        *   * *x* *   ##
# # # # #*# # # # # # #*#  ##
#   ****         *1        ##
# # # # # # # # # #*# # #  ##
#  ** *   *    3           ##
#############################


