2 13 29
#############################
#p f *2       *  ** * *4   ##
# # # # #*# # #*# # # # #  ##
#    * * *** **      *    *##
# #*# # # # #1# #b#1# # #  ##
#          S     **      * ##
# # #*# # # # # #*#*#*#*#  ##
#   *        *   * *X* *   ##
# # # # #*# # # # # # #*#  ##
#   ****         *1        ##
# # # # # # # # # #*# # #  ##
#  ** *   *           3    ##
#############################


